Afrikaans: Michael Bütow, peter hanox
العربية: Ahmed A Khalil, Bassem Abdullah, Mohamed El-Kamony, Mosa AAA, Rudy Zeinoun, salem alajmi, shady abdotr
Български: Boian Valentinov Todorov, ceco, Nas Van Chev, Petra Milanova, Stoyan P. Bonkov
Català: Alex Guardiet, Diego González Lorenzo, Jonathan atkinson, Raül Cambeiro, Raül
Čeština: Dany Stejskal, Grossmann RAdek, Jiri Doubravsky, Marek Kobera, Martin Ambrož, Milan Beliansky, Peter Stelcer, Vlastimil Skacel, Vlastislav Weiner
Cymraeg: Tony Sciubba
Dansk: Christian Wichmann Moesgaard, kenneth krabat, Malthe Sunesen, Lasse Dalegaard, Mark Rosenstand, Tino Didriksen
Deutsch: Amun Abdulla, Benjamin Schröder, Bjoern Schlaak, Buschbeck, Carl-Marcus Pellmann, Chris Anders, Christian Specht, Claus Radloff, Darko Bugarin, Denis Hamann, emre tas, Georg Schuster, Gerald Schaftner, hein blöd, jan, leopold pichlmüller, marcel barion, Martin hoffman, Michael Krämer, Michael Tänzer, Milan Geh, Nando Filigrasso, oliver boht, Petra Wittkopf, riraraffi, Roman Gasser, romy ripperger, rosati, sabit iftari, Sebastian Mosch, S. Hizo, Thomas Gruß, Thomas Magnet, Thomas Sandner, Wilhelm Hahn
Ελληνικά: Nikolaos Gryspolakis, Vasilis Dialinos
Esperanto: Gabriel Beecham
Español: alejandro ariel mac-kay, Ana Lago, arturobibriesca, bernardita errazuriz, Carlos Lozano, Christian Jaramillo, claudia, D4NNy, Damian Antonio Fenocchio, Daniel Gasco Rodriguez, David, elaine de lima, Francisco, Gustavo Attanasio, gustavo chianese, Jaime Blázquez del Hierro, Jazmin Velazquez Lopez, Jovani, juan Perez, juliana, kesar, Lucas Lux, monica, Néstor Peralta, Nicanor, Pablo Canale, pazuzu, rai
Español de Mexico : Alfonso Labastida Zamora, arturobibriesca, Cesar Armando Rodriguez, Daniel Gasco Rodriguez, Francisco, Hugo, Jose Guadalue Alvarez Cordoba, Jovani, juliana, Pablo Canale, zukaboy_gdl
Eesti: Aleksander Härmas, eerik mägi, Priit Laes
Euskara: 3ARRANO.com
فارسی: M.Mahmoudi
Suomi: Aaro Juntunen, ett pok, jeremias leppänen, Juha Heinänen, Matti Tuomola, Matti Viljanen, Ni Mer, Tiia Kärkkäinen, Timo, Ville Virta
Français: Ariel G, Christophe Riviere, David Maciejak, Edouard Biton, finder, Guilhem Bailly, Hamdouch deera, jean vignoli, Jürgen Köster, Lucas Simonch, ludo, Ludovic Mirlatif, Nicolas, Nicolas Staphylas, Philippe Lamalice, Raphael Chabert, richard, samuel boucher, sarah, Sébastien Mouren, Trollnumber1
Gaeilge: Gabriel Beecham, Gareth Peoples
Galego: 
עברית: Amir Aharoni, Amitay, Avi Erel, Elhanan Ben-Yishay, eran raderman, YossiZR
Hrvatski: Anto Anic, djryback, ZeroKillaz
Magyar: Attila Selmeci, Bíró Mariann, esoxxx, Javori Gabor, Kovács Rajmund, laszlo Pataki, les Vorosmarthy, Peter Takacs, Tamas Szanto, tr, Vincze Márton
Հայերեն: Suren Karapetyan
Italiano: alessandra, Alessandro Aglietti, ciccio orso, ennio, Fabrizio Salieri, Federico D'Ambrosio, franco, Fulvio, gian bernetti, Giasone Argo, giuseppe marchetta, Hiram Oswaldo Pena Porras, Marco Solimando, massimo maccolini, matteo, max, Monty, motard, mp, napoli, paolo, paul rollin, pietropanacci, salvatore, serdean, stefano, TheBoss, valery, Valter Ratti, Vincenzo Reale
日本語: Knagi, Masataka Nakamura, Megan E, mitcho (Michael 芳貴 Erlewine), tomoko kanda, Yasushi Iwata
ქართული ენა: Aiet Kolkhi
한국어: Kim, YungGeun, Son, Kyeong-uk, Spade, Steve K Lee, Sung Jae, Cho
Lietuvių: Kestas Ermanas, Vaidas Kiela
Malayalam: Mannar Mathai
Bahasa melayu: Emirin Mohamed Kasah
Norsk bokmål: Arnt Runar Tjøstheim, Guri Norman, Ingmar Hemsen, Philipp Aaholm, tormod
Nederlands: alexanderpas, Carlo Martens, David Visser, David Visser, Dennis Veenstra, eric, Erwin Poeze, Frank Eising, Frank Jacobs, Fred Brouwer, ger lanslots, Gijsbert Ooms, Jan Schut, Koen Vits, Levi Roelofsma, manuel, Martijn van Gene, Michel Pauwels, M.J.Louwe, noah, Patrick Catthoor, Paul Kassebaum, Petra van Assen, Roy Mietes, sofie clissen, Tijmen, vanessa, Wolf Hijlkema
Norsk Nynorsk: Frode
Polski: Adam Andrzejewski, Bartek Wisniewski, Citrus, crashload, jerzy czaja -szwajcer, Jozef Rozmus, Konrad Mantorski, Marek Adam, Markus Valen, Michal Durys, olek lorenc, Piotr Drąg, Piotr Gospodarek, Szymon Adamczyk, Tomasz Kłosiński
Português: Carlos, João Pedro Pais, Luis Antonio Domingues, sepulveda, Tiago Dias Bugarin, Tiago Filipe Gonçalves Afonso Sousa da Silva, Vandrei Cerqueira
Português do Brasil: Augusto Uehara, Carlos Werner , Édipo Antunes, Eduardo Tormento, Gustavo Bruno, juvas men, maycon souza, Natanael Pinho, Paulo Anselmo de Oliveira, Renan Valente Rangel, Renato, Tiago Dias Bugarin, Vandrei Cerqueira, wanteildo antunes ayres de lima, Wilson Carvalho da Cruz
Română: izabela, Lupoiu Victor Alexandru, Manea Costin, peter pann, Radu Ciuca, Radu Costel-Adrian
Русский: Andrey Kuznetsov, Andrey, Dmitry Bogatykh, Dmitry Bogatykh, Dmitry Morozov, Efremov, jevgenij, Lozovoy Vasiliy, Pavel Maryanov, Pavel Vlasov, Shangin Alexander, Vika, Vladislav Zavyalov, Yuri
Slovenský: Andrej Palička, fork27, jakub siska, jefko, Lukáš Lalinský, patrik r, savas, Tibor Vrskovy
Slovensko: A.V., Dušan Mulac, Ervin, Jure Repinc, Jure Repinc
Shqipe: arianit, Nick
Svenska: Alexander Berglund, Christoffer Söderholm, David Vilhelmsson Ronad, Essi, Gabriela Soto Mora, Gustav Tiger, Henrik, Jonas Hedberg, Joop van der Lei, Markus, Martin Svensson, mattias söderberg, Stefan, T. N., William Noritis
	తెలుగు: Madan Meka
ภาษาไทย: Supiti Buranawatanachoke, Yongyut Booncherd
tlhIngan-Hol: chris curran
Türkçe: Elnur Mehdi, Erhan Abay, Eryen AKGÜN, Levent, Mehmet Ergene, m.eminogullari@gmail.com, Oguzhan Yuzabasıoglu, Özcan Arslan, Ozgur Basar, Veysel Harun Sahin, z
Українська: Andrew Lahush, Denis Mostovlyuk, Yakov Glumov
Tiê?ng Viê?t: Clytie Siddall
简体中文: ERIC, Lee Fui Ling, Li Jiaxiang, Qiang Yuan, ricky, Tang Kai Yiu, thesues, xueyong, Yang Hong, ZhouMo
繁體中文: abbie, Abel Cheung, alex lee, cheng-han chiang, Cheng Ka Ho, Hin, Jamie, kourge, Lee Fui Ling, ming chang, something else, Tang Kai Yiu, Tony Tsang, Vincent M, wongpoyee, Zeus Cho, Zhu He
